11111111111111111
10P00000000000001
1000C000000000001
10000000000000001
1000C000000000001
1000C000000000001
1000C000000000001
10000000000000001
1000C000000000001
10C000000000000E1
11111111111111111