111111111111
10P000000001
1000C0000001
10C000000001
100000000001
100000000001
100000000E01
111111111111