11111
10P01
10001
10C01
10001
10001
100E1
11111