11111111111111
1P0C0000000001
10000000000001
100C0000000001
10000000000001
100000000E0001
10000000000001
100000C00E0001
11111111111111