111111111111111111111111111111
100000000000000001000000000001
10P000000000000001000000000001
10000000000000000100000C000001
100000000000000001000000000001
1000000000C0000001111100000001
1000C0000000000000000000000001
100000000000000000000000000001
100000010000000000000000000001
10000001000000000000C000000001
100000010000000000000000000001
100000010000000C00000000000001
100000000000000000000000000001
100000000000000000000000000001
1000011110000C0000000000000001
100000001000000000000011111001
100000001000000000000000000001
100000C0100000000000000E000001
100000001000000000000000000001
100000001000000000000000000001
111111111111111111111111111111