11111111111111111111111111
10000000000000000100000001
10P00000000000000100000001
100000000000000001000C0001
10000000000000000100000001
1000000000C000000111110001
1000C000000000000000000001
10000000000000000000000001
10000001000000000000000001
100000010000000C0000000001
1000011110000C000000000001
10000000100000000011111001
10000000100000000000000001
100000C010000000000E000001
10000000100000000000000001
10000000100000000000000001
11111111111111111111111111
